{
  "width": 20,
  "height": 15,
  "tile_size": 32,
  "layers": {
    "background": [
      [3, 3, 3, 3, 3, 3, 3, 3, 3, 3, 3, 3, 3, 3, 3, 3, 3, 3, 3, 3],
      [3, 1, 1, 1, 1, 1, 1, 1, 1, 1, 1, 1, 1, 1, 1, 1, 1, 1, 1, 3],
      [3, 1, 2, 2, 2, 2, 2, 2, 2, 2, 2, 2, 2, 2, 2, 2, 2, 2, 1, 3],
      [3, 1, 2, 3, 3, 3, 3, 3, 3, 3, 3, 3, 3, 3, 3, 3, 3, 2, 1, 3],
      [3, 1, 2, 3, 2, 2, 2, 2, 2, 2, 2, 2, 2, 2, 2, 2, 3, 2, 1, 3],
      [3, 1, 2, 3, 2, 1, 1, 1, 1, 1, 1, 1, 1, 1, 1, 2, 3, 2, 1, 3],
      [3, 1, 2, 3, 2, 1, 2, 2, 2, 2, 2, 2, 2, 2, 1, 2, 3, 2, 1, 3],
      [3, 1, 2, 3, 2, 1, 2, 2, 2, 2, 2, 2, 2, 2, 1, 2, 3, 2, 1, 3],
      [3, 1, 2, 3, 2, 1, 2, 2, 2, 2, 2, 2, 2, 2, 1, 2, 3, 2, 1, 3],
      [3, 1, 2, 3, 2, 1, 1, 1, 1, 1, 1, 1, 1, 1, 1, 2, 3, 2, 1, 3],
      [3, 1, 2, 3, 2, 2, 2, 2, 2, 2, 2, 2, 2, 2, 2, 2, 3, 2, 1, 3],
      [3, 1, 2, 3, 3, 3, 3, 3, 3, 3, 3, 3, 3, 3, 3, 3, 3, 2, 1, 3],
      [3, 1, 2, 2, 2, 2, 2, 2, 2, 2, 2, 2, 2, 2, 2, 2, 2, 2, 1, 3],
      [3, 1, 1, 1, 1, 1, 1, 1, 1, 1, 1, 1, 1, 1, 1, 1, 1, 1, 1, 3],
      [3, 3, 3, 3, 3, 3, 3, 3, 3, 3, 3, 3, 3, 3, 3, 3, 3, 3, 3, 3]
    ],
    "collision": [
      [1, 1, 1, 1, 1, 1, 1, 1, 1, 1, 1, 1, 1, 1, 1, 1, 1, 1, 1, 1],
      [1, 1, 1, 1, 1, 1, 1, 1, 1, 1, 1, 1, 1, 1, 1, 1, 1, 1, 1, 1],
      [1, 1, 0, 0, 0, 0, 0, 0, 0, 0, 0, 0, 0, 0, 0, 0, 0, 0, 1, 1],
      [1, 1, 0, 1, 1, 1, 1, 1, 1, 1, 1, 1, 1, 1, 1, 1, 1, 0, 1, 1],
      [1, 1, 0, 1, 0, 0, 0, 0, 0, 0, 0, 0, 0, 0, 0, 0, 1, 0, 1, 1],
      [1, 1, 0, 1, 0, 1, 1, 1, 1, 1, 1, 1, 1, 1, 1, 0, 1, 0, 1, 1],
      [1, 1, 0, 1, 0, 1, 0, 0, 0, 0, 0, 0, 0, 0, 1, 0, 1, 0, 1, 1],
      [1, 1, 0, 1, 0, 1, 0, 0, 0, 0, 0, 0, 0, 0, 1, 0, 1, 0, 1, 1],
      [1, 1, 0, 1, 0, 1, 0, 0, 0, 0, 0, 0, 0, 0, 1, 0, 1, 0, 1, 1],
      [1, 1, 0, 1, 0, 1, 1, 1, 1, 1, 1, 1, 1, 1, 1, 0, 1, 0, 1, 1],
      [1, 1, 0, 1, 0, 0, 0, 0, 0, 0, 0, 0, 0, 0, 0, 0, 1, 0, 1, 1],
      [1, 1, 0, 1, 1, 1, 1, 1, 1, 1, 1, 1, 1, 1, 1, 1, 1, 0, 1, 1],
      [1, 1, 0, 0, 0, 0, 0, 0, 0, 0, 0, 0, 0, 0, 0, 0, 0, 0, 1, 1],
      [1, 1, 1, 1, 1, 1, 1, 1, 1, 1, 1, 1, 1, 1, 1, 1, 1, 1, 1, 1]
    ],
    "objects": [
      {
        "type": "enemy",
        "x": 200,
        "y": 150,
        "enemy_type": "orc"
      },
      {
        "type": "enemy",
        "x": 400,
        "y": 200,
        "enemy_type": "orc"
      },
      {
        "type": "enemy",
        "x": 300,
        "y": 250,
        "enemy_type": "skeleton"
      },
      {
        "type": "enemy",
        "x": 250,
        "y": 300,
        "enemy_type": "goblin"
      },
      {
        "type": "enemy",
        "x": 350,
        "y": 300,
        "enemy_type": "goblin"
      },
      {
        "type": "item",
        "x": 300,
        "y": 200,
        "item_type": "health_potion"
      },
      {
        "type": "item",
        "x": 320,
        "y": 220,
        "item_type": "experience_gem"
      },
      {
        "type": "door",
        "x": 288,
        "y": 100,
        "door_id": "victory_door",
        "target_map": "assets/maps/test_map.json",
        "target_position": [160, 160],
        "width": 48,
        "height": 32
      }
    ]
  },
  "transitions": {
    "boundaries": {},
    "zones": [],
    "doors": []
  }
}