{
  "width": 18,
  "height": 14,
  "tile_size": 32,
  "layers": {
    "background": [
      [1, 1, 1, 1, 1, 1, 1, 1, 1, 1, 1, 1, 1, 1, 1, 1, 1, 1],
      [1, 2, 2, 2, 2, 2, 2, 2, 1, 1, 2, 2, 2, 2, 2, 2, 2, 1],
      [1, 2, 3, 3, 3, 3, 3, 2, 1, 1, 2, 3, 3, 3, 3, 3, 2, 1],
      [1, 2, 3, 2, 2, 2, 3, 2, 1, 1, 2, 3, 2, 2, 2, 3, 2, 1],
      [1, 2, 3, 2, 2, 2, 3, 2, 2, 2, 2, 3, 2, 2, 2, 3, 2, 1],
      [1, 2, 3, 2, 2, 2, 3, 2, 2, 2, 2, 3, 2, 2, 2, 3, 2, 1],
      [1, 2, 3, 3, 2, 3, 3, 2, 2, 2, 2, 3, 3, 2, 3, 3, 2, 1],
      [1, 2, 2, 2, 2, 2, 2, 2, 2, 2, 2, 2, 2, 2, 2, 2, 2, 1],
      [1, 2, 3, 3, 2, 3, 3, 2, 2, 2, 2, 3, 3, 2, 3, 3, 2, 1],
      [1, 2, 3, 2, 2, 2, 3, 2, 2, 2, 2, 3, 2, 2, 2, 3, 2, 1],
      [1, 2, 3, 2, 2, 2, 3, 2, 2, 2, 2, 3, 2, 2, 2, 3, 2, 1],
      [1, 2, 3, 2, 2, 2, 3, 2, 1, 1, 2, 3, 2, 2, 2, 3, 2, 1],
      [1, 2, 2, 2, 2, 2, 2, 2, 1, 1, 2, 2, 2, 2, 2, 2, 2, 1],
      [1, 1, 1, 1, 1, 1, 1, 1, 1, 1, 1, 1, 1, 1, 1, 1, 1, 1]
    ],
    "collision": [
      [1, 1, 1, 1, 1, 1, 1, 1, 1, 1, 1, 1, 1, 1, 1, 1, 1, 1],
      [1, 0, 0, 0, 0, 0, 0, 0, 1, 1, 0, 0, 0, 0, 0, 0, 0, 1],
      [1, 0, 1, 1, 1, 1, 1, 0, 1, 1, 0, 1, 1, 1, 1, 1, 0, 1],
      [1, 0, 1, 0, 0, 0, 1, 0, 1, 1, 0, 1, 0, 0, 0, 1, 0, 1],
      [1, 0, 1, 0, 0, 0, 1, 0, 0, 0, 0, 1, 0, 0, 0, 1, 0, 1],
      [1, 0, 1, 0, 0, 0, 1, 0, 0, 0, 0, 1, 0, 0, 0, 1, 0, 1],
      [1, 0, 1, 1, 0, 1, 1, 0, 0, 0, 0, 1, 1, 0, 1, 1, 0, 1],
      [1, 0, 0, 0, 0, 0, 0, 0, 0, 0, 0, 0, 0, 0, 0, 0, 0, 1],
      [1, 0, 1, 1, 0, 1, 1, 0, 0, 0, 0, 1, 1, 0, 1, 1, 0, 1],
      [1, 0, 1, 0, 0, 0, 1, 0, 0, 0, 0, 1, 0, 0, 0, 1, 0, 1],
      [1, 0, 1, 0, 0, 0, 1, 0, 0, 0, 0, 1, 0, 0, 0, 1, 0, 1],
      [1, 0, 1, 0, 0, 0, 1, 0, 1, 1, 0, 1, 0, 0, 0, 1, 0, 1],
      [1, 0, 0, 0, 0, 0, 0, 0, 1, 1, 0, 0, 0, 0, 0, 0, 0, 1],
      [1, 1, 1, 1, 1, 1, 1, 1, 1, 1, 1, 1, 1, 1, 1, 1, 1, 1]
    ],
    "objects": [
      {
        "type": "enemy",
        "x": 120,
        "y": 120,
        "enemy_type": "orc"
      },
      {
        "type": "enemy",
        "x": 400,
        "y": 180,
        "enemy_type": "goblin"
      },
      {
        "type": "enemy",
        "x": 280,
        "y": 240,
        "enemy_type": "skeleton"
      },
      {
        "type": "enemy",
        "x": 480,
        "y": 320,
        "enemy_type": "orc"
      },
      {
        "type": "item",
        "x": 200,
        "y": 200,
        "item_type": "health_potion"
      },
      {
        "type": "item",
        "x": 350,
        "y": 280,
        "item_type": "iron_sword"
      },
      {
        "type": "door",
        "x": 270,
        "y": 50,
        "door_id": "stage3_exit",
        "target_map": "assets/maps/final_stage.json",
        "target_position": [288, 350],
        "width": 48,
        "height": 32
      }
    ]
  },
  "transitions": {
    "boundaries": {},
    "zones": [],
    "doors": []
  }
}