{
  "width": 15,
  "height": 12,
  "tile_size": 32,
  "layers": {
    "background": [
      [3, 3, 3, 3, 3, 3, 3, 3, 3, 3, 3, 3, 3, 3, 3],
      [3, 2, 2, 2, 2, 2, 2, 2, 2, 2, 2, 2, 2, 2, 3],
      [3, 2, 1, 1, 1, 1, 1, 1, 1, 1, 1, 1, 1, 2, 3],
      [3, 2, 1, 2, 2, 2, 2, 2, 2, 2, 2, 2, 1, 2, 3],
      [3, 2, 1, 2, 2, 2, 2, 2, 2, 2, 2, 2, 1, 2, 3],
      [3, 2, 1, 2, 2, 2, 2, 2, 2, 2, 2, 2, 1, 2, 3],
      [3, 2, 1, 2, 2, 2, 2, 2, 2, 2, 2, 2, 1, 2, 3],
      [3, 2, 1, 2, 2, 2, 2, 2, 2, 2, 2, 2, 1, 2, 3],
      [3, 2, 1, 1, 1, 1, 1, 1, 1, 1, 1, 1, 1, 2, 3],
      [3, 2, 2, 2, 2, 2, 2, 2, 2, 2, 2, 2, 2, 2, 3],
      [3, 2, 2, 2, 2, 2, 2, 2, 2, 2, 2, 2, 2, 2, 3],
      [3, 3, 3, 3, 3, 3, 3, 3, 3, 3, 3, 3, 3, 3, 3]
    ],
    "collision": [
      [1, 1, 1, 1, 1, 1, 1, 1, 1, 1, 1, 1, 1, 1, 1],
      [1, 0, 0, 0, 0, 0, 0, 0, 0, 0, 0, 0, 0, 0, 1],
      [1, 0, 1, 1, 1, 1, 1, 1, 1, 1, 1, 1, 1, 0, 1],
      [1, 0, 1, 0, 0, 0, 0, 0, 0, 0, 0, 0, 1, 0, 1],
      [1, 0, 1, 0, 0, 0, 0, 0, 0, 0, 0, 0, 1, 0, 1],
      [1, 0, 1, 0, 0, 0, 0, 0, 0, 0, 0, 0, 1, 0, 1],
      [1, 0, 1, 0, 0, 0, 0, 0, 0, 0, 0, 0, 1, 0, 1],
      [1, 0, 1, 0, 0, 0, 0, 0, 0, 0, 0, 0, 1, 0, 1],
      [1, 0, 1, 1, 1, 1, 1, 1, 1, 1, 1, 1, 1, 0, 1],
      [1, 0, 0, 0, 0, 0, 0, 0, 0, 0, 0, 0, 0, 0, 1],
      [1, 0, 0, 0, 0, 0, 0, 0, 0, 0, 0, 0, 0, 0, 1],
      [1, 1, 1, 1, 1, 1, 1, 1, 1, 1, 1, 1, 1, 1, 1]
    ],
    "objects": [
      {
        "type": "enemy",
        "x": 150,
        "y": 120,
        "enemy_type": "skeleton"
      },
      {
        "type": "item",
        "x": 240,
        "y": 180,
        "item_type": "magic_potion"
      },
      {
        "type": "enemy",
        "x": 320,
        "y": 250,
        "enemy_type": "goblin"
      }
    ]
  },
  "transitions": {
    "boundaries": {
      "south": {
        "target_map": "assets/maps/test_map.json",
        "target_position": [400, 50]
      }
    },
    "zones": [
      {
        "id": "portal_back",
        "area": {
          "x": 200,
          "y": 300,
          "width": 64,
          "height": 32
        },
        "target_map": "assets/maps/test_map.json",
        "target_position": [300, 200]
      }
    ],
    "doors": []
  }
}